111111111111111111111111111
1                  1      1
1 1111 11   1 1111 1  1 1 1
1      1111   1  1 1  1 1 1
1 111  1  1 1 1  111  1 1 1
1   11111 1 1 1 1     1 1 1
1 1       1 1 1 1   1 1 121
1 1 11111 111 1  1  1 1 111
1S1 1         1  1  1 1 1 0
111 11111 11111  1 21 121 1
1 1       11 21  1111 111 1
1 1211111 11  1           1
1 1111  1     1 111111 1111
1       1 11  1  1 211    1
1 1111111 11111  1  11    1
1 1     1 1   1  1  11 11 1
1 1 11121 1 111  1 111  1 1
1 1 11111 1     2       1 1
1 1       1  111 1111 111 1
1    1 1111  121          1
1 1111       1 111 11 11111
1   2  1111  1      1     1
111111111111111111111111111