111111111111111
1  2   2 112 11
1 1 111       1
111 111   111 1
111  1111 11111
1  2   1 2   11
1    1111  1211
111   2 1 11  0
111 211 1 11111
1111 11 1  2111
1111S12 1121111
111111111111111
