111111111111
12  1   2  1
1 1 1 111  0
1 2    21111
1 1111  1121
1  211  11 1
11  11     1
111 111 1111
1         11
1 11111 1 21
12  21121S11
111111111111